-##################
##----------------#
#-$****##########-#
#-#-------------#-#
#-#-***********-#-#
#-#-*---------*-#-#
#-#-*-#######-*-#-#
#-#-*-#-----#-*-#-#
#-#-*-#-----#-*-#-#
#-#-*-#-----#-*-#-#
#-#-*-#-----#-*-#-#
#-#-*-#-----#@*-#-#
#-#-*-#######**-#-#
#-#-*-----------#-#
#-#-***********##-#
#-*---------------#
#-#***#######**.-##
#---------------##-
#################--