--#######-----------------##############-------
--#-----###################-----#---#--#-------
--#-$---------------------$-$-$---$-$$-#-------
--##-####################$$-###-.-###--#---####
--#--#----##----###--*--#--#####*####--#####--#
--#-$#-##-##-##.$-$-----*..#--$...*-#--#------#
--#--#-#--*-*-###-########.*---.**#---##-#*#*-#
####-#-#-#--#-##-----$-#-..*...-*.###$##-#-@-##
#----#-#------#--$-#--.*....*.*-$----$-#-#*###-
#--#.--########---###############.####---#--#--
#-.#######---###########-------#-.-.-#####--#--
#-$------$---$---------#-$-$---$$--$-#####--#--
#-.##################--#########-#####------#--
####----------------#-#-----#-.-.-####*###--#--
--------------------#---$-$-.-$---*---$-#####--
--------------------#--############-----#------
--------------------####----------#######------