################---
#--------------##--
#$##*$***$***$--###
#.-#-.-.-.-*-#--$-#
#$.-*$#$#$#-.$*-#-#
#.$.-*-.-*-.$.$.$-#
#-*$.-*$*-.$*-*-#-#
#.$.$.-*-.$.$.$.$-#
#-*-*$.-.$*-*-*-#-#
#.$.$.$+$.$.$.$.$-#
#-*-*$.-.$*-*-*-#-#
#.$.$.-*-.$.$.$.$-#
#-*$.-*$*-.$*-*-#-#
#.$.-*-.-*-.$.$.$-#
#$.-#$#$#$#-.$*-#-#
#.-*-.-.-.-*-.$.$-#
#-*$*$*$*$*$*$*-#-#
#.-.-.-.-.-.-.-..-#
#$###$###$###$#-###
#---------------#--
#################--