--------------###############---
--------------#--#--#-------##--
-------########*---*#-$-$-$--#--
-------#-----.#--#-*-######$-#--
--######-*$.$-#-*#-.---#--$--#--
--#-.--*-#--*-#--#-*-$-*-----#--
--#-.*$*-#-*$*#-*####-###**#*###
-##-$$-*-#.-$-#--####-#-#-*-*@*#
-#---.-$-#-#*-#*.#--#-#-#*-*-*-#
-#-#$.$#.##------#$.--#-#-*-*--#
-#.$-.--.#--##****--###-#*-*-*-#
-##*######$#-----##-#####-*-*--#
-##-#-*-.-*--.-#-##------*-*-*-#
-#--#---$---#-*--##-#####---*--#
##-.#####$####-####-#######-####
#---#-$---##.-.*.*.$-------*---#
#-#$*..*.-*-*##-*----$.###-.-#-#
#---#-$---#---*-#-#########**-##
#####-###--*$.#-#-----------*--#
---#--#-###---#--#-*$*--#**#*#-#
---#-######*#.---#$$-*-#-------#
-###-...##----*-#-$..-##-$*#-*.#
-#-$$#..##-$*#-*#-#-*$--##---#-#
-#---$**####----#--...$.---##--#
##-$$-.-#####################-##
#-$-#----------------------*---#
#-----######################---#
#######--------------------#####