#############
########-.--#
########-.$.#
#######--*$-#
######--*.$.#
####-+-*$.$$#
###--$--*.$.#
##--*.*--*$-#
#--*$$$*-.$.#
#-$.....*---#
#.$$$$$$$.###
#--.-*-.--###
#############